R 1000 1000
SO ./textures/south.xpm
NO ./textures/north.xpm

WE ./textures/west.xpm
EA ./textures/east.xpm

S        ./textures/slime.xpm
F    0,154,225
C    255,124,0



        1111111111111111111111111
        1000000000110000000000001
        1011000001110000000000001
        1001000000000000000000001
111111111011000001110000000000001
100000000011000001110111111111111
11110111111111011100000010001
11110111111111011101010010001
11000000110101011100000010001
10000000000000001100000000201
10000001000000000000000000001
10000000000000001101010010001
11000001110101011111011000E0111
11110111 1110101 101111010001
11111111 1111111 111111111111
