R 1000 1000
SO ./textures/south.xpm
NO ./textures/north.xpm
WE ./textures/west.xpm
S ./textures/pillar.xpm
EA ./textures/east.xpm
F  4,33,120
C  123,111,123


        1111111111111111111111111
        1000000000000000000000001
        1100000000000000000000001
        100000000000000000000W001
111111111000000000000000000000001
100000000000000000000000000001111
100000002000000111111100000001
1000000020000001     100000001
1000000020000001 111 100000001
1000000000000001 1011100000001
1000000000000001 1000000000001
1100000111010101 1111011110101
11110111 1110121 1011110100011
11111111 1111111 1111111111111