R 400 1
SO ./textures/south.xpm
NO ./textures/north.xpm
WE ./textures/west.xpm
S ./textures/pillar.xpm
EA ./textures/east.xpm
F 0,154,225
C 255,124,0

        1111111111111111111111111
        1000000000110000000000021
        101100000111000000000021
        1001000000000000200000011
111111111011000001110000000000001
100000000011000001110111111111111
11110111111111011100000010001
11110111111111011101010010001 1111111
11000000110101011100000010001 10000001
10000000000000001100000000201 11111111
10000200002000000000000000001
10000000000000001101010010001
11000001110101011111011000N0111
11110111 1110101 101111010001
11111111 1111111 111111111111
